4
437 316 597 476
10
2 2 2 1 0
20
21 21 21 21 21 21 21 21 21 23 28
21 24 21 24 24 24 24 24 24 21 28
21 24 21 21 22 21 21 21 24 21 28
21 24 21 21 21 22 21 21 24 21 28
21 24 21 21 25 24 21 21 24 21 28
22 24 21 21 22 21 21 21 24 21 28
21 24 21 21 21 22 21 21 24 21 28
21 24 21 24 24 24 24 24 24 21 28
21 21 21 21 21 21 21 21 21 21 29