4
477 335 557 615
2 2 2 2 2
20
24 24 21 21 21 24 21 21 28
23 24 21 21 22 24 21 21 28
21 24 21 21 21 24 24 22 28
21 24 21 21 24 24 21 27 28
21 24 21 21 21 26 22 21 28
21 21 22 24 21 24 21 21 28
21 21 21 24 21 24 21 27 28
21 21 25 21 21 26 21 21 29
