4
500 357 660 477
10
2 2 2 1 0
20
21 21 21 21 21 22 21 23 28
21 24 24 21 24 24 24 21 28
21 24 21 22 21 21 24 21 28
21 24 21 21 25 21 24 21 28
21 24 21 22 21 21 24 21 28
21 24 21 24 24 24 24 21 28
21 21 21 21 21 21 21 21 29